#####
#   #
# o #
#   #
#px #
#   #
#####
