############
#        o #
#   p   ####
#          #
#######    #
#  o ##    #
#    ##    #
#          #
#       xx #
#       #  #
############
