############
#        o #
#   p ######
#          #
#     #    #
#######    #
#  o ##    #
#  # ##    #
#          #
# x#    xx #
#     o #  #
############
