############
#   o    o #     #########
#     ######     #    x o#
#          #     #  x    #
#     #    ##### #  x    #
#######        ###     x #
#  o ##    ##   x  ooo x #
#  # ##    ##  ### opo x #
#          #   # #########
# x#    xx #####
#     o #  #
############
