##############
#o p         #
######  x    #
     #  x    #
     #      o#
     #########
